CCCCCWWWWWCCCCCWWWWWCCCCCWWWWCCCCCCCCCWWCCCCCWWWWWCCCCCWWWWWCCCCCWWWWWCCCCCWWWWCCCCCCCCCWWCCCCCWWWWWCCCCCWWWWWCCCCCWWWWWCCCCCWWWWCCCCCCCCCWWCCCCCWWWWWCCCCCWWWWWCCCCCWWWWWCCCCCWWWWCCCCCCCCCWWCCCCCWWWWWCCCCCWWWWWCCCCCWWWWWCCCCCWWWWCCCCCCCCCWWCCCCCWWWWWCCCCCWWWWWCCCCCWWWWWCCCCCWWWWCCCCCCCCCWWCCCCCWWWWWCCCCCWWWWWCCCCCWWWWWCCCCCWWWWCCCCCCCCCWWCCCCCWWWWWCCCCCWWWWWCCCCCWWWWWCCCCCWWWWCCCCCCCCCWWCCCCCWWWWW
WWWWCWWWWWWCWWWCCCCWWWWWCCCCCCWWWCWWWCWWWWWWWWWWCCWWWWCWWWWWWCWWWCCCCWWWWWCCCCCCWWWCWWWCWWWWWWWWWWCCWWWWCWWWWWWCWWWCCCCWWWWWCCCCCCWWWCWWWCWWWWWWWWWWCCWWWWCWWWWWWCWWWCCCCWWWWWCCCCCCWWWCWWWCWWWWWWWWWWCCWWWWCWWWWWWCWWWCCCCWWWWWCCCCCCWWWCWWWCWWWWWWWWWWCCWWWWCWWWWWWCWWWCCCCWWWWWCCCCCCWWWCWWWCWWWWWWWWWWCCWWWWCWWWWWWCWWWCCCCWWWWWCCCCCCWWWCWWWCWWWWWWWWWWCCWWWWCWWWWWWCWWWCCCCWWWWWCCCCCCWWWCWWWCWWWWWWWWWWCT
WWWWCCCCCCCWWWWWCWCWWWWWCWCWCWCCCCCCCCCCCCCCCCCCCCWWWWCCCCCCCWWWWWCWCWWWWWCWCWCWCCCCCCCCCCCCCCCCCCCCWWWWCCCCCCCWWWWWCWCWWWWWCWCWCWCCCCCCCCCCCCCCCCCCCCWWWWCCCCCCCWWWWWCWCWWWWWCWCWCWCCCCCCCCCCCCCCCCCCCCWWWWCCCCCCCWWWWWCWCWWWWWCWCWCWCCCCCCCCCCCCCCCCCCCCWWWWCCCCCCCWWWWWCWCWWWWWCWCWCWCCCCCCCCCCCCCCCCCCCCWWWWCCCCCCCWWWWWCWCWWWWWCWCWCWCCCCCCCCCCCCCCCCCCCCWWWWCCCCCCCWWWWWCWCWWWWWCWCWCWCCCCCCCCCCCCCCCCCCCC
WWCCCCCCCCCCCCWWWWWWWCCCCWCWWWWWWWWWWWWWWWWWWWWWCWWWCCCCCCCCCCCCWWWWWWWCCCCWCWWWWWWWWWWWWWWWWWWWWWCWWWCCCCCCCCCCCCWWWWWWWCCCCWCWWWWWWWWWWWWWWWWWWWWWCWWWCCCCCCCCCCCCWWWWWWWCCCCWCWWWWWWWWWWWWWWWWWWWWWCWWWCCCCCCCCCCCCWWWWWWWCCCCWCWWWWWWWWWWWWWWWWWWWWWCWWWCCCCCCCCCCCCWWWWWWWCCCCWCWWWWWWWWWWWWWWWWWWWWWCWWWCCCCCCCCCCCCWWWWWWWCCCCWCWWWWWWWWWWWWWWWWWWWWWCWWWCCCCCCCCCCCCWWWWWWWCCCCWCWWWWWWWWWWWWWWWWWWWWWCW
WCCWWWCWWWWWWCCCCCCCWWWCCWWWCCCCCCCCWWWWWWWWCCCWWCWCCWWWCWWWWWWCCCCCCCWWWCCWWWCCCCCCCCWWWWWWWWCCCWWCWCCWWWCWWWWWWCCCCCCCWWWCCWWWCCCCCCCCWWWWWWWWCCCWWCWCCWWWCWWWWWWCCCCCCCWWWCCWWWCCCCCCCCWWWWWWWWCCCWWCWCCWWWCWWWWWWCCCCCCCWWWCCWWWCCCCCCCCWWWWWWWWCCCWWCWCCWWWCWWWWWWCCCCCCCWWWCCWWWCCCCCCCCWWWWWWWWCCCWWCWCCWWWCWWWWWWCCCCCCCWWWCCWWWCCCCCCCCWWWWWWWWCCCWWCWCCWWWCWWWWWWCCCCCCCWWWCCWWWCCCCCCCCWWWWWWWWCCCWWC
WCCCCWWCWWWWWCCWWCCCCCCWCCCCCCCCCCWCCCCCCCCCCCCCCCWCCCCWWCWWWWWCCWWCCCCCCWCCCCCCCCCCWCCCCCCCCCCCCCCCWCCCCWWCWWWWWCCWWCCCCCCWCCCCCCCCCCWCCCCCCCCCCCCCCCWCCCCWWCWWWWWCCWWCCCCCCWCCCCCCCCCCWCCCCCCCCCCCCCCCWCCCCWWCWWWWWCCWWCCCCCCWCCCCCCCCCCWCCCCCCCCCCCCCCCWCCCCWWCWWWWWCCWWCCCCCCWCCCCCCCCCCWCCCCCCCCCCCCCCCWCCCCWWCWWWWWCCWWCCCCCCWCCCCCCCCCCWCCCCCCCCCCCCCCCWCCCCWWCWWWWWCCWWCCCCCCWCCCCCCCCCCWCCCCCCCCCCCCCCC
WWCWCWCCWWCCWWWWWWWCCCCWWWWWWWCWCWCWWWWWWWWCCCCCCCWWCWCWCCWWCCWWWWWWWCCCCWWWWWWWCWCWCWWWWWWWWCCCCCCCWWCWCWCCWWCCWWWWWWWCCCCWWWWWWWCWCWCWWWWWWWWCCCCCCCWWCWCWCCWWCCWWWWWWWCCCCWWWWWWWCWCWCWWWWWWWWCCCCCCCWWCWCWCCWWCCWWWWWWWCCCCWWWWWWWCWCWCWWWWWWWWCCCCCCCWWCWCWCCWWCCWWWWWWWCCCCWWWWWWWCWCWCWWWWWWWWCCCCCCCWWCWCWCCWWCCWWWWWWWCCCCWWWWWWWCWCWCWWWWWWWWCCCCCCCWWCWCWCCWWCCWWWWWWWCCCCWWWWWWWCWCWCWWWWWWWWCCCCCCC
WCCWCWCCWWCCWWWWWWWCCCCWWWWWWCWCWCCWCCCCCWWCCCCCCCWCCWCWCCWWCCWWWWWWWCCCCWWWWWWCWCWCCWCCCCCWWCCCCCCCWCCWCWCCWWCCWWWWWWWCCCCWWWWWWCWCWCCWCCCCCWWCCCCCCCWCCWCWCCWWCCWWWWWWWCCCCWWWWWWCWCWCCWCCCCCWWCCCCCCCWCCWCWCCWWCCWWWWWWWCCCCWWWWWWCWCWCCWCCCCCWWCCCCCCCWCCWCWCCWWCCWWWWWWWCCCCWWWWWWCWCWCCWCCCCCWWCCCCCCCWCCWCWCCWWCCWWWWWWWCCCCWWWWWWCWCWCCWCCCCCWWCCCCCCCWCCWCWCCWWCCWWWWWWWCCCCWWWWWWCWCWCCWCCCCCWWCCCCCCC
WWWWCWCCWWCCWWWWWWWCCCCWWWWWWCCCCCCCCCWCCCCCCCCCCCWWWWCWCCWWCCWWWWWWWCCCCWWWWWWCCCCCCCCCWCCCCCCCCCCCWWWWCWCCWWCCWWWWWWWCCCCWWWWWWCCCCCCCCCWCCCCCCCCCCCWWWWCWCCWWCCWWWWWWWCCCCWWWWWWCCCCCCCCCWCCCCCCCCCCCWWWWCWCCWWCCWWWWWWWCCCCWWWWWWCCCCCCCCCWCCCCCCCCCCCWWWWCWCCWWCCWWWWWWWCCCCWWWWWWCCCCCCCCCWCCCCCCCCCCCWWWWCWCCWWCCWWWWWWWCCCCWWWWWWCCCCCCCCCWCCCCCCCCCCCWWWWCWCCWWCCWWWWWWWCCCCWWWWWWCCCCCCCCCWCCCCCCCCCCC
WCCCCWWCWWWCWCCCCCWWWCCWWCCCCCWWWWWWWWWWWWWWWCCCWWWCCCCWWCWWWCWCCCCCWWWCCWWCCCCCWWWWWWWWWWWWWWWCCCWWWCCCCWWCWWWCWCCCCCWWWCCWWCCCCCWWWWWWWWWWWWWWWCCCWWWCCCCWWCWWWCWCCCCCWWWCCWWCCCCCWWWWWWWWWWWWWWWCCCWWWCCCCWWCWWWCWCCCCCWWWCCWWCCCCCWWWWWWWWWWWWWWWCCCWWWCCCCWWCWWWCWCCCCCWWWCCWWCCCCCWWWWWWWWWWWWWWWCCCWWWCCCCWWCWWWCWCCCCCWWWCCWWCCCCCWWWWWWWWWWWWWWWCCCWWWCCCCWWCWWWCWCCCCCWWWCCWWCCCCCWWWWWWWWWWWWWWWCCCWW
WCWWWWWCCCCCWWWWWWWWWWCWWCCCCCCCCCCCCCCCCCCCCWWCWWWCWWWWWCCCCCWWWWWWWWWWCWWCCCCCCCCCCCCCCCCCCCCWWCWWWCWWWWWCCCCCWWWWWWWWWWCWWCCCCCCCCCCCCCCCCCCCCWWCWWWCWWWWWCCCCCWWWWWWWWWWCWWCCCCCCCCCCCCCCCCCCCCWWCWWWCWWWWWCCCCCWWWWWWWWWWCWWCCCCCCCCCCCCCCCCCCCCWWCWWWCWWWWWCCCCCWWWWWWWWWWCWWCCCCCCCCCCCCCCCCCCCCWWCWWWCWWWWWCCCCCWWWWWWWWWWCWWCCCCCCCCCCCCCCCCCCCCWWCWWWCWWWWWCCCCCWWWWWWWWWWCWWCCCCCCCCCCCCCCCCCCCCWWCWW
WCCCCCCCCCCCCCCCCCCWWWWWWCCCWWWWWWWWWWWWWWWWCWWCWWWCCCCCCCCCCCCCCCCCCWWWWWWCCCWWWWWWWWWWWWWWWWCWWCWWWCCCCCCCCCCCCCCCCCCWWWWWWCCCWWWWWWWWWWWWWWWWCWWCWWWCCCCCCCCCCCCCCCCCCWWWWWWCCCWWWWWWWWWWWWWWWWCWWCWWWCCCCCCCCCCCCCCCCCCWWWWWWCCCWWWWWWWWWWWWWWWWCWWCWWWCCCCCCCCCCCCCCCCCCWWWWWWCCCWWWWWWWWWWWWWWWWCWWCWWWCCCCCCCCCCCCCCCCCCWWWWWWCCCWWWWWWWWWWWWWWWWCWWCWWWCCCCCCCCCCCCCCCCCCWWWWWWCCCWWWWWWWWWWWWWWWWCWWCWW
CCCCCWWWWWWWWWWWCCCWWWWWWCWWWWWWWWWWWWWWWWWCCCWCCCCCCCCWWWWWWWWWWWCCCWWWWWWCWWWWWWWWWWWWWWWWWCCCWCCCCCCCCWWWWWWWWWWWCCCWWWWWWCWWWWWWWWWWWWWWWWWCCCWCCCCCCCCWWWWWWWWWWWCCCWWWWWWCWWWWWWWWWWWWWWWWWCCCWCCCCCCCCWWWWWWWWWWWCCCWWWWWWCWWWWWWWWWWWWWWWWWCCCWCCCCCCCCWWWWWWWWWWWCCCWWWWWWCWWWWWWWWWWWWWWWWWCCCWCCCCCCCCWWWWWWWWWWWCCCWWWWWWCWWWWWWWWWWWWWWWWWCCCWCCCCCCCCWWWWWWWWWWWCCCWWWWWWCWWWWWWWWWWWWWWWWWCCCWCCC
CCCCCCCCCCCCCCCWWCCCCCCCWWWCCCCCCCCCCCCCCCCCWWWWWWCCCCCCCCCCCCCCCWWCCCCCCCWWWCCCCCCCCCCCCCCCCCWWWWWWCCCCCCCCCCCCCCCWWCCCCCCCWWWCCCCCCCCCCCCCCCCCWWWWWWCCCCCCCCCCCCCCCWWCCCCCCCWWWCCCCCCCCCCCCCCCCCWWWWWWCCCCCCCCCCCCCCCWWCCCCCCCWWWCCCCCCCCCCCCCCCCCWWWWWWCCCCCCCCCCCCCCCWWCCCCCCCWWWCCCCCCCCCCCCCCCCCWWWWWWCCCCCCCCCCCCCCCWWCCCCCCCWWWCCCCCCCCCCCCCCCCCWWWWWWCCCCCCCCCCCCCCCWWCCCCCCCWWWCCCCCCCCCCCCCCCCCWWWWWW
WWCCCWWWWWWCWCWCCCWWWWCCCCWWWWWWCWWWWWCWWCWWCCCCWWWWCCCWWWWWWCWCWCCCWWWWCCCCWWWWWWCWWWWWCWWCWWCCCCWWWWCCCWWWWWWCWCWCCCWWWWCCCCWWWWWWCWWWWWCWWCWWCCCCWWWWCCCWWWWWWCWCWCCCWWWWCCCCWWWWWWCWWWWWCWWCWWCCCCWWWWCCCWWWWWWCWCWCCCWWWWCCCCWWWWWWCWWWWWCWWCWWCCCCWWWWCCCWWWWWWCWCWCCCWWWWCCCCWWWWWWCWWWWWCWWCWWCCCCWWWWCCCWWWWWWCWCWCCCWWWWCCCCWWWWWWCWWWWWCWWCWWCCCCWWWWCCCWWWWWWCWCWCCCWWWWCCCCWWWWWWCWWWWWCWWCWWCCCCWW
WWWWWWWWCCCCWWWWWWWWWWWWWCWWWWCCCCWWWWCCCCWWCWWCWWWWWWWWWWCCCCWWWWWWWWWWWWWCWWWWCCCCWWWWCCCCWWCWWCWWWWWWWWWWCCCCWWWWWWWWWWWWWCWWWWCCCCWWWWCCCCWWCWWCWWWWWWWWWWCCCCWWWWWWWWWWWWWCWWWWCCCCWWWWCCCCWWCWWCWWWWWWWWWWCCCCWWWWWWWWWWWWWCWWWWCCCCWWWWCCCCWWCWWCWWWWWWWWWWCCCCWWWWWWWWWWWWWCWWWWCCCCWWWWCCCCWWCWWCWWWWWWWWWWCCCCWWWWWWWWWWWWWCWWWWCCCCWWWWCCCCWWCWWCWWWWWWWWWWCCCCWWWWWWWWWWWWWCWWWWCCCCWWWWCCCCWWCWWCWW
CCCCCCCCCCCCCCCCCCCCCCCCWCCCCWWWCCCCCCWWWCCCCWWCWWCCCCCCCCCCCCCCCCCCCCCCCCWCCCCWWWCCCCCCWWWCCCCWWCWWCCCCCCCCCCCCCCCCCCCCCCCCWCCCCWWWCCCCCCWWWCCCCWWCWWCCCCCCCCCCCCCCCCCCCCCCCCWCCCCWWWCCCCCCWWWCCCCWWCWWCCCCCCCCCCCCCCCCCCCCCCCCWCCCCWWWCCCCCCWWWCCCCWWCWWCCCCCCCCCCCCCCCCCCCCCCCCWCCCCWWWCCCCCCWWWCCCCWWCWWCCCCCCCCCCCCCCCCCCCCCCCCWCCCCWWWCCCCCCWWWCCCCWWCWWCCCCCCCCCCCCCCCCCCCCCCCCWCCCCWWWCCCCCCWWWCCCCWWCWW
CCCCCCCCCCCCCCCCCCCCCCCCWCCCCWWWCCCCCCWWWCCCCWWCWWCCCCCCCCCCCCCCCCCCCCCCCCWCCCCWWWCCCCCCWWWCCCCWWCWWCCCCCCCCCCCCCCCCCCCCCCCCWCCCCWWWCCCCCCWWWCCCCWWCWWCCCCCCCCCCCCCCCCCCCCCCCCWCCCCWWWCCCCCCWWWCCCCWWCWWCCCCCCCCCCCCCCCCCCCCCCCCWCCCCWWWCCCCCCWWWCCCCWWCWWCCCCCCCCCCCCCCCCCCCCCCCCWCCCCWWWCCCCCCWWWCCCCWWCWWCCCCCCCCCCCCCCCCCCCCCCCCWCCCCWWWCCCCCCWWWCCCCWWCWWCCCCCCCCCCCCCCCCCCCCCCCCWCCCCWWWCCCCCCWWWCCCCWWCWW
WCCCCCCCCCCCWWCWWWWCWWWWWWWWWWWWCCCCCCCCCCWWWCWCWWWCCCCCCCCCCCWWCWWWWCWWWWWWWWWWWWCCCCCCCCCCWWWCWCWWWCCCCCCCCCCCWWCWWWWCWWWWWWWWWWWWCCCCCCCCCCWWWCWCWWWCCCCCCCCCCCWWCWWWWCWWWWWWWWWWWWCCCCCCCCCCWWWCWCWWWCCCCCCCCCCCWWCWWWWCWWWWWWWWWWWWCCCCCCCCCCWWWCWCWWWCCCCCCCCCCCWWCWWWWCWWWWWWWWWWWWCCCCCCCCCCWWWCWCWWWCCCCCCCCCCCWWCWWWWCWWWWWWWWWWWWCCCCCCCCCCWWWCWCWWWCCCCCCCCCCCWWCWWWWCWWWWWWWWWWWWCCCCCCCCCCWWWCWCWW
WCWWWWWWWWCCCCCCCCCCWWWWWWWWWWWWWWWWWWCWCCCWWCCCWWWCWWWWWWWWCCCCCCCCCCWWWWWWWWWWWWWWWWWWCWCCCWWCCCWWWCWWWWWWWWCCCCCCCCCCWWWWWWWWWWWWWWWWWWCWCCCWWCCCWWWCWWWWWWWWCCCCCCCCCCWWWWWWWWWWWWWWWWWWCWCCCWWCCCWWWCWWWWWWWWCCCCCCCCCCWWWWWWWWWWWWWWWWWWCWCCCWWCCCWWWCWWWWWWWWCCCCCCCCCCWWWWWWWWWWWWWWWWWWCWCCCWWCCCWWWCWWWWWWWWCCCCCCCCCCWWWWWWWWWWWWWWWWWWCWCCCWWCCCWWWCWWWWWWWWCCCCCCCCCCWWWWWWWWWWWWWWWWWWCWCCCWWCCCWW
WCCCCCWWWWCWWWWWWWWWCCCCCCCCCWWWWWWWCWCCWWWWWWWWWWWCCCCCWWWWCWWWWWWWWWCCCCCCCCCWWWWWWWCWCCWWWWWWWWWWWCCCCCWWWWCWWWWWWWWWCCCCCCCCCWWWWWWWCWCCWWWWWWWWWWWCCCCCWWWWCWWWWWWWWWCCCCCCCCCWWWWWWWCWCCWWWWWWWWWWWCCCCCWWWWCWWWWWWWWWCCCCCCCCCWWWWWWWCWCCWWWWWWWWWWWCCCCCWWWWCWWWWWWWWWCCCCCCCCCWWWWWWWCWCCWWWWWWWWWWWCCCCCWWWWCWWWWWWWWWCCCCCCCCCWWWWWWWCWCCWWWWWWWWWWWCCCCCWWWWCWWWWWWWWWCCCCCCCCCWWWWWWWCWCCWWWWWWWWWW
WCCCWWWCCCCCCCCCCWWWWWWWWCCCCCWCCCWWCWWCCCCCCCCCCCWCCCWWWCCCCCCCCCCWWWWWWWWCCCCCWCCCWWCWWCCCCCCCCCCCWCCCWWWCCCCCCCCCCWWWWWWWWCCCCCWCCCWWCWWCCCCCCCCCCCWCCCWWWCCCCCCCCCCWWWWWWWWCCCCCWCCCWWCWWCCCCCCCCCCCWCCCWWWCCCCCCCCCCWWWWWWWWCCCCCWCCCWWCWWCCCCCCCCCCCWCCCWWWCCCCCCCCCCWWWWWWWWCCCCCWCCCWWCWWCCCCCCCCCCCWCCCWWWCCCCCCCCCCWWWWWWWWCCCCCWCCCWWCWWCCCCCCCCCCCWCCCWWWCCCCCCCCCCWWWWWWWWCCCCCWCCCWWCWWCCCCCCCCCCC
WCCCCCCCWWWCCWWWWWCCCWWCCCCCWWWCWCWCCCCWWWWWWCCCWWWCCCCCCCWWWCCWWWWWCCCWWCCCCCWWWCWCWCCCCWWWWWWCCCWWWCCCCCCCWWWCCWWWWWCCCWWCCCCCWWWCWCWCCCCWWWWWWCCCWWWCCCCCCCWWWCCWWWWWCCCWWCCCCCWWWCWCWCCCCWWWWWWCCCWWWCCCCCCCWWWCCWWWWWCCCWWCCCCCWWWCWCWCCCCWWWWWWCCCWWWCCCCCCCWWWCCWWWWWCCCWWCCCCCWWWCWCWCCCCWWWWWWCCCWWWCCCCCCCWWWCCWWWWWCCCWWCCCCCWWWCWCWCCCCWWWWWWCCCWWWCCCCCCCWWWCCWWWWWCCCWWCCCCCWWWCWCWCCCCWWWWWWCCCWW
WWWWCCWWWWWWWWWWWWCWWWWWWWWWWWWCWWWWWWWWWWWWWWCWWWWWWWCCWWWWWWWWWWWWCWWWWWWWWWWWWCWWWWWWWWWWWWWWCWWWWWWWCCWWWWWWWWWWWWCWWWWWWWWWWWWCWWWWWWWWWWWWWWCWWWWWWWCCWWWWWWWWWWWWCWWWWWWWWWWWWCWWWWWWWWWWWWWWCWWWWWWWCCWWWWWWWWWWWWCWWWWWWWWWWWWCWWWWWWWWWWWWWWCWWWWWWWCCWWWWWWWWWWWWCWWWWWWWWWWWWCWWWWWWWWWWWWWWCWWWWWWWCCWWWWWWWWWWWWCWWWWWWWWWWWWCWWWWWWWWWWWWWWCWWWWWWWCCWWWWWWWWWWWWCWWWWWWWWWWWWCWWWWWWWWWWWWWWCWWW
CCCCCCCCCCCCCCCCCCCCCCCCCCCCCCCCCCCCCCCCCCCCCCCCCCCCCCCCCCCCCCCCCCCCCCCCCCCCCCCCCCCCCCCCCCCCCCCCCCCCCCCCCCCCCCCCCCCCCCCCCCCCCCCCCCCCCCCCCCCCCCCCCCCCCCCCCCCCCCCCCCCCCCCCCCCCCCCCCCCCCCCCCCCCCCCCCCCCCCCCCCCCCCCCCCCCCCCCCCCCCCCCCCCCCCCCCCCCCCCCCCCCCCCCCCCCCCCCCCCCCCCCCCCCCCCCCCCCCCCCCCCCCCCCCCCCCCCCCCCCCCCCCCCCCCCCCCCCCCCCCCCCCCCCCCCCCCCCCCCCCCCCCCCCCCCCCCCCCCCCCCCCCCCCCCCCCCCCCCCCCCCCCCCCCCCCCCCCCCCC