CCCCCWWWWWCCCCCWWWWWCCCCCWWWWCCCCCCCCCWWCCCCCWWWWW
WWWWCWWWWWWCWWWCCCCWWWWWCCCCCCWWWCWWWCWWWWWWWWWWCT
WWWWCCCCCCCWWWWWCWCWWWWWCWCWCWCCCCCCCCCCCCCCCCCCCC
WWCCCCCCCCCCCCWWWWWWWCCCCWCWWWWWWWWWWWWWWWWWWWWWCW
WCCWWWCWWWWWWCCCCCCCWWWCCWWWCCCCCCCCWWWWWWWWCCCWWC
WCCCCWWCWWWWWCCWWCCCCCCWCCCCCCCCCCWCCCCCCCCCCCCCCC
WWCWCWCCWWCCWWWWWWWCCCCWWWWWWWCWCWCWWWWWWWWCCCCCCC
WCCWCWCCWWCCWWWWWWWCCCCWWWWWWCWCWCCWCCCCCWWCCCCCCC
WWWWCWCCWWCCWWWWWWWCCCCWWWWWWCCCCCCCCCWCCCCCCCCCCC
WCCCCWWCWWWCWCCCCCWWWCCWWCCCCCWWWWWWWWWWWWWWWCCCWW
WCWWWWWCCCCCWWWWWWWWWWCWWCCCCCCCCCCCCCCCCCCCCWWCWW
WCCCCCCCCCCCCCCCCCCWWWWWWCCCWWWWWWWWWWWWWWWWCWWCWW
CCCCCWWWWWWWWWWWCCCWWWWWWCWWWWWWWWWWWWWWWWWCCCWCCC
CCCCCCCCCCCCCCCWWCCCCCCCWWWCCCCCCCCCCCCCCCCCWWWWWW
WWCCCWWWWWWCWCWCCCWWWWCCCCWWWWWWCWWWWWCWWCWWCCCCWW
WWWWWWWWCCCCWWWWWWWWWWWWWCWWWWCCCCWWWWCCCCWWCWWCWW
CCCCCCCCCCCCCCCCCCCCCCCCWCCCCWWWCCCCCCWWWCCCCWWCWW
CWWWWWWWWWWWWWWWWWWCCCCCWWWWWWWWCWWWWWWWWCWWWCWCWW
WCCCCCCCCCCCWWCWWWWCWWWWWWWWWWWWCCCCCCCCCCWWWCWCWW
WCWWWWWWWWCCCCCCCCCCWWWWWWWWWWWWWWWWWWCWCCCWWCCCWW
WCCCCCWWWWCWWWWWWWWWCCCCCCCCCWWWWWWWCWCCWWWWWWWWWW
WCCCWWWCCCCCCCCCCWWWWWWWWCCCCCWCCCWWCWWCCCCCCCCCCC
WCCCCCCCWWWCCWWWWWCCCWWCCCCCWWWCWCWCCCCWWWWWWCCCWW
WWWWCCWWWWWWWWWWWWCWWWWWWWWWWWWCWWWWWWWWWWWWWWCWWW
CCCCCCCCCCCCCCCCCCCCCCCCCCCCCCCCCCCCCCCCCCCCCCCCCC