CCCCCWWWWWCCCCCWWWWWCCCCCWWWWCCCCCCCCCWWCCCCCWWWWWCCCCCWWWWWCCCCCWWWWWCCCCCWWWWCCCCCCCCCWWCCCCCWWWWWCCCCCWWWWWCCCCCWWWWWCCCCCWWWWCCCCCCCCCWWCCCCCWWWWWCCCCCWWWWWCCCCCWWWWWCCCCCWWWWCCCCCCCCCWWCCCCCWWWWWCCCCCWWWWWCCCCCWWWWWCCCCCWWWWCCCCCCCCCWWCCCCCWWWWWCCCCCWWWWWCCCCCWWWWWCCCCCWWWWCCCCCCCCCWWCCCCCWWWWWCCCCCWWWWWCCCCCWWWWWCCCCCWWWWCCCCCCCCCWWCCCCCWWWWWCCCCCWWWWWCCCCCWWWWWCCCCCWWWWCCCCCCCCCWWCCCCCWWWWWCCCCCWWWWWCCCCCWWWWWCCCCCWWWWCCCCCCCCCWWCCCCCWWWWWCCCCCWWWWWCCCCCWWWWWCCCCCWWWWCCCCCCCCCWWCCCCCWWWWWCCCCCWWWWWCCCCCWWWWWCCCCCWWWWCCCCCCCCCWWCCCCCWWWWWCCCCCWWWWWCCCCCWWWWWCCCCCWWWWCCCCCCCCCWWCCCCCWWWWWCCCCCWWWWWCCCCCWWWWWCCCCCWWWWCCCCCCCCCWWCCCCCWWWWWCCCCCWWWWWCCCCCWWWWWCCCCCWWWWCCCCCCCCCWWCCCCCWWWWWCCCCCWWWWWCCCCCWWWWWCCCCCWWWWCCCCCCCCCWWCCCCCWWWWWCCCCCWWWWWCCCCCWWWWWCCCCCWWWWCCCCCCCCCWWCCCCCWWWWW
WWWWCWWWWWWCWWWCCCCWWWWWCCCCCCWWWCWWWCWWWWWWWWWWCCWWWWCWWWWWWCWWWCCCCWWWWWCCCCCCWWWCWWWCWWWWWWWWWWCCWWWWCWWWWWWCWWWCCCCWWWWWCCCCCCWWWCWWWCWWWWWWWWWWCCWWWWCWWWWWWCWWWCCCCWWWWWCCCCCCWWWCWWWCWWWWWWWWWWCCWWWWCWWWWWWCWWWCCCCWWWWWCCCCCCWWWCWWWCWWWWWWWWWWCCWWWWCWWWWWWCWWWCCCCWWWWWCCCCCCWWWCWWWCWWWWWWWWWWCCWWWWCWWWWWWCWWWCCCCWWWWWCCCCCCWWWCWWWCWWWWWWWWWWCCWWWWCWWWWWWCWWWCCCCWWWWWCCCCCCWWWCWWWCWWWWWWWWWWCCWWWWCWWWWWWCWWWCCCCWWWWWCCCCCCWWWCWWWCWWWWWWWWWWCCWWWWCWWWWWWCWWWCCCCWWWWWCCCCCCWWWCWWWCWWWWWWWWWWCCWWWWCWWWWWWCWWWCCCCWWWWWCCCCCCWWWCWWWCWWWWWWWWWWCCWWWWCWWWWWWCWWWCCCCWWWWWCCCCCCWWWCWWWCWWWWWWWWWWCCWWWWCWWWWWWCWWWCCCCWWWWWCCCCCCWWWCWWWCWWWWWWWWWWCCWWWWCWWWWWWCWWWCCCCWWWWWCCCCCCWWWCWWWCWWWWWWWWWWCCWWWWCWWWWWWCWWWCCCCWWWWWCCCCCCWWWCWWWCWWWWWWWWWWCCWWWWCWWWWWWCWWWCCCCWWWWWCCCCCCWWWCWWWCWWWWWWWWWWCT
WWWWCCCCCCCWWWWWCWCWWWWWCWCWCWCCCCCCCCCCCCCCCCCCCCWWWWCCCCCCCWWWWWCWCWWWWWCWCWCWCCCCCCCCCCCCCCCCCCCCWWWWCCCCCCCWWWWWCWCWWWWWCWCWCWCCCCCCCCCCCCCCCCCCCCWWWWCCCCCCCWWWWWCWCWWWWWCWCWCWCCCCCCCCCCCCCCCCCCCCWWWWCCCCCCCWWWWWCWCWWWWWCWCWCWCCCCCCCCCCCCCCCCCCCCWWWWCCCCCCCWWWWWCWCWWWWWCWCWCWCCCCCCCCCCCCCCCCCCCCWWWWCCCCCCCWWWWWCWCWWWWWCWCWCWCCCCCCCCCCCCCCCCCCCCWWWWCCCCCCCWWWWWCWCWWWWWCWCWCWCCCCCCCCCCCCCCCCCCCCWWWWCCCCCCCWWWWWCWCWWWWWCWCWCWCCCCCCCCCCCCCCCCCCCCWWWWCCCCCCCWWWWWCWCWWWWWCWCWCWCCCCCCCCCCCCCCCCCCCCWWWWCCCCCCCWWWWWCWCWWWWWCWCWCWCCCCCCCCCCCCCCCCCCCCWWWWCCCCCCCWWWWWCWCWWWWWCWCWCWCCCCCCCCCCCCCCCCCCCCWWWWCCCCCCCWWWWWCWCWWWWWCWCWCWCCCCCCCCCCCCCCCCCCCCWWWWCCCCCCCWWWWWCWCWWWWWCWCWCWCCCCCCCCCCCCCCCCCCCCWWWWCCCCCCCWWWWWCWCWWWWWCWCWCWCCCCCCCCCCCCCCCCCCCCWWWWCCCCCCCWWWWWCWCWWWWWCWCWCWCCCCCCCCCCCCCCCCCCCC
WWCCCCCCCCCCCCWWWWWWWCCCCWCWWWWWWWWWWWWWWWWWWWWWCWWWCCCCCCCCCCCCWWWWWWWCCCCWCWWWWWWWWWWWWWWWWWWWWWCWWWCCCCCCCCCCCCWWWWWWWCCCCWCWWWWWWWWWWWWWWWWWWWWWCWWWCCCCCCCCCCCCWWWWWWWCCCCWCWWWWWWWWWWWWWWWWWWWWWCWWWCCCCCCCCCCCCWWWWWWWCCCCWCWWWWWWWWWWWWWWWWWWWWWCWWWCCCCCCCCCCCCWWWWWWWCCCCWCWWWWWWWWWWWWWWWWWWWWWCWWWCCCCCCCCCCCCWWWWWWWCCCCWCWWWWWWWWWWWWWWWWWWWWWCWWWCCCCCCCCCCCCWWWWWWWCCCCWCWWWWWWWWWWWWWWWWWWWWWCWWWCCCCCCCCCCCCWWWWWWWCCCCWCWWWWWWWWWWWWWWWWWWWWWCWWWCCCCCCCCCCCCWWWWWWWCCCCWCWWWWWWWWWWWWWWWWWWWWWCWWWCCCCCCCCCCCCWWWWWWWCCCCWCWWWWWWWWWWWWWWWWWWWWWCWWWCCCCCCCCCCCCWWWWWWWCCCCWCWWWWWWWWWWWWWWWWWWWWWCWWWCCCCCCCCCCCCWWWWWWWCCCCWCWWWWWWWWWWWWWWWWWWWWWCWWWCCCCCCCCCCCCWWWWWWWCCCCWCWWWWWWWWWWWWWWWWWWWWWCWWWCCCCCCCCCCCCWWWWWWWCCCCWCWWWWWWWWWWWWWWWWWWWWWCWWWCCCCCCCCCCCCWWWWWWWCCCCWCWWWWWWWWWWWWWWWWWWWWWCW
WCCWWWCWWWWWWCCCCCCCWWWCCWWWCCCCCCCCWWWWWWWWCCCWWCWCCWWWCWWWWWWCCCCCCCWWWCCWWWCCCCCCCCWWWWWWWWCCCWWCWCCWWWCWWWWWWCCCCCCCWWWCCWWWCCCCCCCCWWWWWWWWCCCWWCWCCWWWCWWWWWWCCCCCCCWWWCCWWWCCCCCCCCWWWWWWWWCCCWWCWCCWWWCWWWWWWCCCCCCCWWWCCWWWCCCCCCCCWWWWWWWWCCCWWCWCCWWWCWWWWWWCCCCCCCWWWCCWWWCCCCCCCCWWWWWWWWCCCWWCWCCWWWCWWWWWWCCCCCCCWWWCCWWWCCCCCCCCWWWWWWWWCCCWWCWCCWWWCWWWWWWCCCCCCCWWWCCWWWCCCCCCCCWWWWWWWWCCCWWCWCCWWWCWWWWWWCCCCCCCWWWCCWWWCCCCCCCCWWWWWWWWCCCWWCWCCWWWCWWWWWWCCCCCCCWWWCCWWWCCCCCCCCWWWWWWWWCCCWWCWCCWWWCWWWWWWCCCCCCCWWWCCWWWCCCCCCCCWWWWWWWWCCCWWCWCCWWWCWWWWWWCCCCCCCWWWCCWWWCCCCCCCCWWWWWWWWCCCWWCWCCWWWCWWWWWWCCCCCCCWWWCCWWWCCCCCCCCWWWWWWWWCCCWWCWCCWWWCWWWWWWCCCCCCCWWWCCWWWCCCCCCCCWWWWWWWWCCCWWCWCCWWWCWWWWWWCCCCCCCWWWCCWWWCCCCCCCCWWWWWWWWCCCWWCWCCWWWCWWWWWWCCCCCCCWWWCCWWWCCCCCCCCWWWWWWWWCCCWWC
WCCCCWWCWWWWWCCWWCCCCCCWCCCCCCCCCCWCCCCCCCCCCCCCCCWCCCCWWCWWWWWCCWWCCCCCCWCCCCCCCCCCWCCCCCCCCCCCCCCCWCCCCWWCWWWWWCCWWCCCCCCWCCCCCCCCCCWCCCCCCCCCCCCCCCWCCCCWWCWWWWWCCWWCCCCCCWCCCCCCCCCCWCCCCCCCCCCCCCCCWCCCCWWCWWWWWCCWWCCCCCCWCCCCCCCCCCWCCCCCCCCCCCCCCCWCCCCWWCWWWWWCCWWCCCCCCWCCCCCCCCCCWCCCCCCCCCCCCCCCWCCCCWWCWWWWWCCWWCCCCCCWCCCCCCCCCCWCCCCCCCCCCCCCCCWCCCCWWCWWWWWCCWWCCCCCCWCCCCCCCCCCWCCCCCCCCCCCCCCCWCCCCWWCWWWWWCCWWCCCCCCWCCCCCCCCCCWCCCCCCCCCCCCCCCWCCCCWWCWWWWWCCWWCCCCCCWCCCCCCCCCCWCCCCCCCCCCCCCCCWCCCCWWCWWWWWCCWWCCCCCCWCCCCCCCCCCWCCCCCCCCCCCCCCCWCCCCWWCWWWWWCCWWCCCCCCWCCCCCCCCCCWCCCCCCCCCCCCCCCWCCCCWWCWWWWWCCWWCCCCCCWCCCCCCCCCCWCCCCCCCCCCCCCCCWCCCCWWCWWWWWCCWWCCCCCCWCCCCCCCCCCWCCCCCCCCCCCCCCCWCCCCWWCWWWWWCCWWCCCCCCWCCCCCCCCCCWCCCCCCCCCCCCCCCWCCCCWWCWWWWWCCWWCCCCCCWCCCCCCCCCCWCCCCCCCCCCCCCCC
WWCWCWCCWWCCWWWWWWWCCCCWWWWWWWCWCWCWWWWWWWWCCCCCCCWWCWCWCCWWCCWWWWWWWCCCCWWWWWWWCWCWCWWWWWWWWCCCCCCCWWCWCWCCWWCCWWWWWWWCCCCWWWWWWWCWCWCWWWWWWWWCCCCCCCWWCWCWCCWWCCWWWWWWWCCCCWWWWWWWCWCWCWWWWWWWWCCCCCCCWWCWCWCCWWCCWWWWWWWCCCCWWWWWWWCWCWCWWWWWWWWCCCCCCCWWCWCWCCWWCCWWWWWWWCCCCWWWWWWWCWCWCWWWWWWWWCCCCCCCWWCWCWCCWWCCWWWWWWWCCCCWWWWWWWCWCWCWWWWWWWWCCCCCCCWWCWCWCCWWCCWWWWWWWCCCCWWWWWWWCWCWCWWWWWWWWCCCCCCCWWCWCWCCWWCCWWWWWWWCCCCWWWWWWWCWCWCWWWWWWWWCCCCCCCWWCWCWCCWWCCWWWWWWWCCCCWWWWWWWCWCWCWWWWWWWWCCCCCCCWWCWCWCCWWCCWWWWWWWCCCCWWWWWWWCWCWCWWWWWWWWCCCCCCCWWCWCWCCWWCCWWWWWWWCCCCWWWWWWWCWCWCWWWWWWWWCCCCCCCWWCWCWCCWWCCWWWWWWWCCCCWWWWWWWCWCWCWWWWWWWWCCCCCCCWWCWCWCCWWCCWWWWWWWCCCCWWWWWWWCWCWCWWWWWWWWCCCCCCCWWCWCWCCWWCCWWWWWWWCCCCWWWWWWWCWCWCWWWWWWWWCCCCCCCWWCWCWCCWWCCWWWWWWWCCCCWWWWWWWCWCWCWWWWWWWWCCCCCCC
WCCWCWCCWWCCWWWWWWWCCCCWWWWWWCWCWCCWCCCCCWWCCCCCCCWCCWCWCCWWCCWWWWWWWCCCCWWWWWWCWCWCCWCCCCCWWCCCCCCCWCCWCWCCWWCCWWWWWWWCCCCWWWWWWCWCWCCWCCCCCWWCCCCCCCWCCWCWCCWWCCWWWWWWWCCCCWWWWWWCWCWCCWCCCCCWWCCCCCCCWCCWCWCCWWCCWWWWWWWCCCCWWWWWWCWCWCCWCCCCCWWCCCCCCCWCCWCWCCWWCCWWWWWWWCCCCWWWWWWCWCWCCWCCCCCWWCCCCCCCWCCWCWCCWWCCWWWWWWWCCCCWWWWWWCWCWCCWCCCCCWWCCCCCCCWCCWCWCCWWCCWWWWWWWCCCCWWWWWWCWCWCCWCCCCCWWCCCCCCCWCCWCWCCWWCCWWWWWWWCCCCWWWWWWCWCWCCWCCCCCWWCCCCCCCWCCWCWCCWWCCWWWWWWWCCCCWWWWWWCWCWCCWCCCCCWWCCCCCCCWCCWCWCCWWCCWWWWWWWCCCCWWWWWWCWCWCCWCCCCCWWCCCCCCCWCCWCWCCWWCCWWWWWWWCCCCWWWWWWCWCWCCWCCCCCWWCCCCCCCWCCWCWCCWWCCWWWWWWWCCCCWWWWWWCWCWCCWCCCCCWWCCCCCCCWCCWCWCCWWCCWWWWWWWCCCCWWWWWWCWCWCCWCCCCCWWCCCCCCCWCCWCWCCWWCCWWWWWWWCCCCWWWWWWCWCWCCWCCCCCWWCCCCCCCWCCWCWCCWWCCWWWWWWWCCCCWWWWWWCWCWCCWCCCCCWWCCCCCCC
WWWWCWCCWWCCWWWWWWWCCCCWWWWWWCCCCCCCCCWCCCCCCCCCCCWWWWCWCCWWCCWWWWWWWCCCCWWWWWWCCCCCCCCCWCCCCCCCCCCCWWWWCWCCWWCCWWWWWWWCCCCWWWWWWCCCCCCCCCWCCCCCCCCCCCWWWWCWCCWWCCWWWWWWWCCCCWWWWWWCCCCCCCCCWCCCCCCCCCCCWWWWCWCCWWCCWWWWWWWCCCCWWWWWWCCCCCCCCCWCCCCCCCCCCCWWWWCWCCWWCCWWWWWWWCCCCWWWWWWCCCCCCCCCWCCCCCCCCCCCWWWWCWCCWWCCWWWWWWWCCCCWWWWWWCCCCCCCCCWCCCCCCCCCCCWWWWCWCCWWCCWWWWWWWCCCCWWWWWWCCCCCCCCCWCCCCCCCCCCCWWWWCWCCWWCCWWWWWWWCCCCWWWWWWCCCCCCCCCWCCCCCCCCCCCWWWWCWCCWWCCWWWWWWWCCCCWWWWWWCCCCCCCCCWCCCCCCCCCCCWWWWCWCCWWCCWWWWWWWCCCCWWWWWWCCCCCCCCCWCCCCCCCCCCCWWWWCWCCWWCCWWWWWWWCCCCWWWWWWCCCCCCCCCWCCCCCCCCCCCWWWWCWCCWWCCWWWWWWWCCCCWWWWWWCCCCCCCCCWCCCCCCCCCCCWWWWCWCCWWCCWWWWWWWCCCCWWWWWWCCCCCCCCCWCCCCCCCCCCCWWWWCWCCWWCCWWWWWWWCCCCWWWWWWCCCCCCCCCWCCCCCCCCCCCWWWWCWCCWWCCWWWWWWWCCCCWWWWWWCCCCCCCCCWCCCCCCCCCCC
WCCCCWWCWWWCWCCCCCWWWCCWWCCCCCWWWWWWWWWWWWWWWCCCWWWCCCCWWCWWWCWCCCCCWWWCCWWCCCCCWWWWWWWWWWWWWWWCCCWWWCCCCWWCWWWCWCCCCCWWWCCWWCCCCCWWWWWWWWWWWWWWWCCCWWWCCCCWWCWWWCWCCCCCWWWCCWWCCCCCWWWWWWWWWWWWWWWCCCWWWCCCCWWCWWWCWCCCCCWWWCCWWCCCCCWWWWWWWWWWWWWWWCCCWWWCCCCWWCWWWCWCCCCCWWWCCWWCCCCCWWWWWWWWWWWWWWWCCCWWWCCCCWWCWWWCWCCCCCWWWCCWWCCCCCWWWWWWWWWWWWWWWCCCWWWCCCCWWCWWWCWCCCCCWWWCCWWCCCCCWWWWWWWWWWWWWWWCCCWWWCCCCWWCWWWCWCCCCCWWWCCWWCCCCCWWWWWWWWWWWWWWWCCCWWWCCCCWWCWWWCWCCCCCWWWCCWWCCCCCWWWWWWWWWWWWWWWCCCWWWCCCCWWCWWWCWCCCCCWWWCCWWCCCCCWWWWWWWWWWWWWWWCCCWWWCCCCWWCWWWCWCCCCCWWWCCWWCCCCCWWWWWWWWWWWWWWWCCCWWWCCCCWWCWWWCWCCCCCWWWCCWWCCCCCWWWWWWWWWWWWWWWCCCWWWCCCCWWCWWWCWCCCCCWWWCCWWCCCCCWWWWWWWWWWWWWWWCCCWWWCCCCWWCWWWCWCCCCCWWWCCWWCCCCCWWWWWWWWWWWWWWWCCCWWWCCCCWWCWWWCWCCCCCWWWCCWWCCCCCWWWWWWWWWWWWWWWCCCWW
WCWWWWWCCCCCWWWWWWWWWWCWWCCCCCCCCCCCCCCCCCCCCWWCWWWCWWWWWCCCCCWWWWWWWWWWCWWCCCCCCCCCCCCCCCCCCCCWWCWWWCWWWWWCCCCCWWWWWWWWWWCWWCCCCCCCCCCCCCCCCCCCCWWCWWWCWWWWWCCCCCWWWWWWWWWWCWWCCCCCCCCCCCCCCCCCCCCWWCWWWCWWWWWCCCCCWWWWWWWWWWCWWCCCCCCCCCCCCCCCCCCCCWWCWWWCWWWWWCCCCCWWWWWWWWWWCWWCCCCCCCCCCCCCCCCCCCCWWCWWWCWWWWWCCCCCWWWWWWWWWWCWWCCCCCCCCCCCCCCCCCCCCWWCWWWCWWWWWCCCCCWWWWWWWWWWCWWCCCCCCCCCCCCCCCCCCCCWWCWWWCWWWWWCCCCCWWWWWWWWWWCWWCCCCCCCCCCCCCCCCCCCCWWCWWWCWWWWWCCCCCWWWWWWWWWWCWWCCCCCCCCCCCCCCCCCCCCWWCWWWCWWWWWCCCCCWWWWWWWWWWCWWCCCCCCCCCCCCCCCCCCCCWWCWWWCWWWWWCCCCCWWWWWWWWWWCWWCCCCCCCCCCCCCCCCCCCCWWCWWWCWWWWWCCCCCWWWWWWWWWWCWWCCCCCCCCCCCCCCCCCCCCWWCWWWCWWWWWCCCCCWWWWWWWWWWCWWCCCCCCCCCCCCCCCCCCCCWWCWWWCWWWWWCCCCCWWWWWWWWWWCWWCCCCCCCCCCCCCCCCCCCCWWCWWWCWWWWWCCCCCWWWWWWWWWWCWWCCCCCCCCCCCCCCCCCCCCWWCWW
WCCCCCCCCCCCCCCCCCCWWWWWWCCCWWWWWWWWWWWWWWWWCWWCWWWCCCCCCCCCCCCCCCCCCWWWWWWCCCWWWWWWWWWWWWWWWWCWWCWWWCCCCCCCCCCCCCCCCCCWWWWWWCCCWWWWWWWWWWWWWWWWCWWCWWWCCCCCCCCCCCCCCCCCCWWWWWWCCCWWWWWWWWWWWWWWWWCWWCWWWCCCCCCCCCCCCCCCCCCWWWWWWCCCWWWWWWWWWWWWWWWWCWWCWWWCCCCCCCCCCCCCCCCCCWWWWWWCCCWWWWWWWWWWWWWWWWCWWCWWWCCCCCCCCCCCCCCCCCCWWWWWWCCCWWWWWWWWWWWWWWWWCWWCWWWCCCCCCCCCCCCCCCCCCWWWWWWCCCWWWWWWWWWWWWWWWWCWWCWWWCCCCCCCCCCCCCCCCCCWWWWWWCCCWWWWWWWWWWWWWWWWCWWCWWWCCCCCCCCCCCCCCCCCCWWWWWWCCCWWWWWWWWWWWWWWWWCWWCWWWCCCCCCCCCCCCCCCCCCWWWWWWCCCWWWWWWWWWWWWWWWWCWWCWWWCCCCCCCCCCCCCCCCCCWWWWWWCCCWWWWWWWWWWWWWWWWCWWCWWWCCCCCCCCCCCCCCCCCCWWWWWWCCCWWWWWWWWWWWWWWWWCWWCWWWCCCCCCCCCCCCCCCCCCWWWWWWCCCWWWWWWWWWWWWWWWWCWWCWWWCCCCCCCCCCCCCCCCCCWWWWWWCCCWWWWWWWWWWWWWWWWCWWCWWWCCCCCCCCCCCCCCCCCCWWWWWWCCCWWWWWWWWWWWWWWWWCWWCWW
CCCCCWWWWWWWWWWWCCCWWWWWWCWWWWWWWWWWWWWWWWWCCCWCCCCCCCCWWWWWWWWWWWCCCWWWWWWCWWWWWWWWWWWWWWWWWCCCWCCCCCCCCWWWWWWWWWWWCCCWWWWWWCWWWWWWWWWWWWWWWWWCCCWCCCCCCCCWWWWWWWWWWWCCCWWWWWWCWWWWWWWWWWWWWWWWWCCCWCCCCCCCCWWWWWWWWWWWCCCWWWWWWCWWWWWWWWWWWWWWWWWCCCWCCCCCCCCWWWWWWWWWWWCCCWWWWWWCWWWWWWWWWWWWWWWWWCCCWCCCCCCCCWWWWWWWWWWWCCCWWWWWWCWWWWWWWWWWWWWWWWWCCCWCCCCCCCCWWWWWWWWWWWCCCWWWWWWCWWWWWWWWWWWWWWWWWCCCWCCCCCCCCWWWWWWWWWWWCCCWWWWWWCWWWWWWWWWWWWWWWWWCCCWCCCCCCCCWWWWWWWWWWWCCCWWWWWWCWWWWWWWWWWWWWWWWWCCCWCCCCCCCCWWWWWWWWWWWCCCWWWWWWCWWWWWWWWWWWWWWWWWCCCWCCCCCCCCWWWWWWWWWWWCCCWWWWWWCWWWWWWWWWWWWWWWWWCCCWCCCCCCCCWWWWWWWWWWWCCCWWWWWWCWWWWWWWWWWWWWWWWWCCCWCCCCCCCCWWWWWWWWWWWCCCWWWWWWCWWWWWWWWWWWWWWWWWCCCWCCCCCCCCWWWWWWWWWWWCCCWWWWWWCWWWWWWWWWWWWWWWWWCCCWCCCCCCCCWWWWWWWWWWWCCCWWWWWWCWWWWWWWWWWWWWWWWWCCCWCCC
CCCCCCCCCCCCCCCWWCCCCCCCWWWCCCCCCCCCCCCCCCCCWWWWWWCCCCCCCCCCCCCCCWWCCCCCCCWWWCCCCCCCCCCCCCCCCCWWWWWWCCCCCCCCCCCCCCCWWCCCCCCCWWWCCCCCCCCCCCCCCCCCWWWWWWCCCCCCCCCCCCCCCWWCCCCCCCWWWCCCCCCCCCCCCCCCCCWWWWWWCCCCCCCCCCCCCCCWWCCCCCCCWWWCCCCCCCCCCCCCCCCCWWWWWWCCCCCCCCCCCCCCCWWCCCCCCCWWWCCCCCCCCCCCCCCCCCWWWWWWCCCCCCCCCCCCCCCWWCCCCCCCWWWCCCCCCCCCCCCCCCCCWWWWWWCCCCCCCCCCCCCCCWWCCCCCCCWWWCCCCCCCCCCCCCCCCCWWWWWWCCCCCCCCCCCCCCCWWCCCCCCCWWWCCCCCCCCCCCCCCCCCWWWWWWCCCCCCCCCCCCCCCWWCCCCCCCWWWCCCCCCCCCCCCCCCCCWWWWWWCCCCCCCCCCCCCCCWWCCCCCCCWWWCCCCCCCCCCCCCCCCCWWWWWWCCCCCCCCCCCCCCCWWCCCCCCCWWWCCCCCCCCCCCCCCCCCWWWWWWCCCCCCCCCCCCCCCWWCCCCCCCWWWCCCCCCCCCCCCCCCCCWWWWWWCCCCCCCCCCCCCCCWWCCCCCCCWWWCCCCCCCCCCCCCCCCCWWWWWWCCCCCCCCCCCCCCCWWCCCCCCCWWWCCCCCCCCCCCCCCCCCWWWWWWCCCCCCCCCCCCCCCWWCCCCCCCWWWCCCCCCCCCCCCCCCCCWWWWWW
WWCCCWWWWWWCWCWCCCWWWWCCCCWWWWWWCWWWWWCWWCWWCCCCWWWWCCCWWWWWWCWCWCCCWWWWCCCCWWWWWWCWWWWWCWWCWWCCCCWWWWCCCWWWWWWCWCWCCCWWWWCCCCWWWWWWCWWWWWCWWCWWCCCCWWWWCCCWWWWWWCWCWCCCWWWWCCCCWWWWWWCWWWWWCWWCWWCCCCWWWWCCCWWWWWWCWCWCCCWWWWCCCCWWWWWWCWWWWWCWWCWWCCCCWWWWCCCWWWWWWCWCWCCCWWWWCCCCWWWWWWCWWWWWCWWCWWCCCCWWWWCCCWWWWWWCWCWCCCWWWWCCCCWWWWWWCWWWWWCWWCWWCCCCWWWWCCCWWWWWWCWCWCCCWWWWCCCCWWWWWWCWWWWWCWWCWWCCCCWWWWCCCWWWWWWCWCWCCCWWWWCCCCWWWWWWCWWWWWCWWCWWCCCCWWWWCCCWWWWWWCWCWCCCWWWWCCCCWWWWWWCWWWWWCWWCWWCCCCWWWWCCCWWWWWWCWCWCCCWWWWCCCCWWWWWWCWWWWWCWWCWWCCCCWWWWCCCWWWWWWCWCWCCCWWWWCCCCWWWWWWCWWWWWCWWCWWCCCCWWWWCCCWWWWWWCWCWCCCWWWWCCCCWWWWWWCWWWWWCWWCWWCCCCWWWWCCCWWWWWWCWCWCCCWWWWCCCCWWWWWWCWWWWWCWWCWWCCCCWWWWCCCWWWWWWCWCWCCCWWWWCCCCWWWWWWCWWWWWCWWCWWCCCCWWWWCCCWWWWWWCWCWCCCWWWWCCCCWWWWWWCWWWWWCWWCWWCCCCWW
WWWWWWWWCCCCWWWWWWWWWWWWWCWWWWCCCCWWWWCCCCWWCWWCWWWWWWWWWWCCCCWWWWWWWWWWWWWCWWWWCCCCWWWWCCCCWWCWWCWWWWWWWWWWCCCCWWWWWWWWWWWWWCWWWWCCCCWWWWCCCCWWCWWCWWWWWWWWWWCCCCWWWWWWWWWWWWWCWWWWCCCCWWWWCCCCWWCWWCWWWWWWWWWWCCCCWWWWWWWWWWWWWCWWWWCCCCWWWWCCCCWWCWWCWWWWWWWWWWCCCCWWWWWWWWWWWWWCWWWWCCCCWWWWCCCCWWCWWCWWWWWWWWWWCCCCWWWWWWWWWWWWWCWWWWCCCCWWWWCCCCWWCWWCWWWWWWWWWWCCCCWWWWWWWWWWWWWCWWWWCCCCWWWWCCCCWWCWWCWWWWWWWWWWCCCCWWWWWWWWWWWWWCWWWWCCCCWWWWCCCCWWCWWCWWWWWWWWWWCCCCWWWWWWWWWWWWWCWWWWCCCCWWWWCCCCWWCWWCWWWWWWWWWWCCCCWWWWWWWWWWWWWCWWWWCCCCWWWWCCCCWWCWWCWWWWWWWWWWCCCCWWWWWWWWWWWWWCWWWWCCCCWWWWCCCCWWCWWCWWWWWWWWWWCCCCWWWWWWWWWWWWWCWWWWCCCCWWWWCCCCWWCWWCWWWWWWWWWWCCCCWWWWWWWWWWWWWCWWWWCCCCWWWWCCCCWWCWWCWWWWWWWWWWCCCCWWWWWWWWWWWWWCWWWWCCCCWWWWCCCCWWCWWCWWWWWWWWWWCCCCWWWWWWWWWWWWWCWWWWCCCCWWWWCCCCWWCWWCWW
CCCCCCCCCCCCCCCCCCCCCCCCWCCCCWWWCCCCCCWWWCCCCWWCWWCCCCCCCCCCCCCCCCCCCCCCCCWCCCCWWWCCCCCCWWWCCCCWWCWWCCCCCCCCCCCCCCCCCCCCCCCCWCCCCWWWCCCCCCWWWCCCCWWCWWCCCCCCCCCCCCCCCCCCCCCCCCWCCCCWWWCCCCCCWWWCCCCWWCWWCCCCCCCCCCCCCCCCCCCCCCCCWCCCCWWWCCCCCCWWWCCCCWWCWWCCCCCCCCCCCCCCCCCCCCCCCCWCCCCWWWCCCCCCWWWCCCCWWCWWCCCCCCCCCCCCCCCCCCCCCCCCWCCCCWWWCCCCCCWWWCCCCWWCWWCCCCCCCCCCCCCCCCCCCCCCCCWCCCCWWWCCCCCCWWWCCCCWWCWWCCCCCCCCCCCCCCCCCCCCCCCCWCCCCWWWCCCCCCWWWCCCCWWCWWCCCCCCCCCCCCCCCCCCCCCCCCWCCCCWWWCCCCCCWWWCCCCWWCWWCCCCCCCCCCCCCCCCCCCCCCCCWCCCCWWWCCCCCCWWWCCCCWWCWWCCCCCCCCCCCCCCCCCCCCCCCCWCCCCWWWCCCCCCWWWCCCCWWCWWCCCCCCCCCCCCCCCCCCCCCCCCWCCCCWWWCCCCCCWWWCCCCWWCWWCCCCCCCCCCCCCCCCCCCCCCCCWCCCCWWWCCCCCCWWWCCCCWWCWWCCCCCCCCCCCCCCCCCCCCCCCCWCCCCWWWCCCCCCWWWCCCCWWCWWCCCCCCCCCCCCCCCCCCCCCCCCWCCCCWWWCCCCCCWWWCCCCWWCWW
CCCCCCCCCCCCCCCCCCCCCCCCWCCCCWWWCCCCCCWWWCCCCWWCWWCCCCCCCCCCCCCCCCCCCCCCCCWCCCCWWWCCCCCCWWWCCCCWWCWWCCCCCCCCCCCCCCCCCCCCCCCCWCCCCWWWCCCCCCWWWCCCCWWCWWCCCCCCCCCCCCCCCCCCCCCCCCWCCCCWWWCCCCCCWWWCCCCWWCWWCCCCCCCCCCCCCCCCCCCCCCCCWCCCCWWWCCCCCCWWWCCCCWWCWWCCCCCCCCCCCCCCCCCCCCCCCCWCCCCWWWCCCCCCWWWCCCCWWCWWCCCCCCCCCCCCCCCCCCCCCCCCWCCCCWWWCCCCCCWWWCCCCWWCWWCCCCCCCCCCCCCCCCCCCCCCCCWCCCCWWWCCCCCCWWWCCCCWWCWWCCCCCCCCCCCCCCCCCCCCCCCCWCCCCWWWCCCCCCWWWCCCCWWCWWCCCCCCCCCCCCCCCCCCCCCCCCWCCCCWWWCCCCCCWWWCCCCWWCWWCCCCCCCCCCCCCCCCCCCCCCCCWCCCCWWWCCCCCCWWWCCCCWWCWWCCCCCCCCCCCCCCCCCCCCCCCCWCCCCWWWCCCCCCWWWCCCCWWCWWCCCCCCCCCCCCCCCCCCCCCCCCWCCCCWWWCCCCCCWWWCCCCWWCWWCCCCCCCCCCCCCCCCCCCCCCCCWCCCCWWWCCCCCCWWWCCCCWWCWWCCCCCCCCCCCCCCCCCCCCCCCCWCCCCWWWCCCCCCWWWCCCCWWCWWCCCCCCCCCCCCCCCCCCCCCCCCWCCCCWWWCCCCCCWWWCCCCWWCWW
WCCCCCCCCCCCWWCWWWWCWWWWWWWWWWWWCCCCCCCCCCWWWCWCWWWCCCCCCCCCCCWWCWWWWCWWWWWWWWWWWWCCCCCCCCCCWWWCWCWWWCCCCCCCCCCCWWCWWWWCWWWWWWWWWWWWCCCCCCCCCCWWWCWCWWWCCCCCCCCCCCWWCWWWWCWWWWWWWWWWWWCCCCCCCCCCWWWCWCWWWCCCCCCCCCCCWWCWWWWCWWWWWWWWWWWWCCCCCCCCCCWWWCWCWWWCCCCCCCCCCCWWCWWWWCWWWWWWWWWWWWCCCCCCCCCCWWWCWCWWWCCCCCCCCCCCWWCWWWWCWWWWWWWWWWWWCCCCCCCCCCWWWCWCWWWCCCCCCCCCCCWWCWWWWCWWWWWWWWWWWWCCCCCCCCCCWWWCWCWWWCCCCCCCCCCCWWCWWWWCWWWWWWWWWWWWCCCCCCCCCCWWWCWCWWWCCCCCCCCCCCWWCWWWWCWWWWWWWWWWWWCCCCCCCCCCWWWCWCWWWCCCCCCCCCCCWWCWWWWCWWWWWWWWWWWWCCCCCCCCCCWWWCWCWWWCCCCCCCCCCCWWCWWWWCWWWWWWWWWWWWCCCCCCCCCCWWWCWCWWWCCCCCCCCCCCWWCWWWWCWWWWWWWWWWWWCCCCCCCCCCWWWCWCWWWCCCCCCCCCCCWWCWWWWCWWWWWWWWWWWWCCCCCCCCCCWWWCWCWWWCCCCCCCCCCCWWCWWWWCWWWWWWWWWWWWCCCCCCCCCCWWWCWCWWWCCCCCCCCCCCWWCWWWWCWWWWWWWWWWWWCCCCCCCCCCWWWCWCWW
WCWWWWWWWWCCCCCCCCCCWWWWWWWWWWWWWWWWWWCWCCCWWCCCWWWCWWWWWWWWCCCCCCCCCCWWWWWWWWWWWWWWWWWWCWCCCWWCCCWWWCWWWWWWWWCCCCCCCCCCWWWWWWWWWWWWWWWWWWCWCCCWWCCCWWWCWWWWWWWWCCCCCCCCCCWWWWWWWWWWWWWWWWWWCWCCCWWCCCWWWCWWWWWWWWCCCCCCCCCCWWWWWWWWWWWWWWWWWWCWCCCWWCCCWWWCWWWWWWWWCCCCCCCCCCWWWWWWWWWWWWWWWWWWCWCCCWWCCCWWWCWWWWWWWWCCCCCCCCCCWWWWWWWWWWWWWWWWWWCWCCCWWCCCWWWCWWWWWWWWCCCCCCCCCCWWWWWWWWWWWWWWWWWWCWCCCWWCCCWWWCWWWWWWWWCCCCCCCCCCWWWWWWWWWWWWWWWWWWCWCCCWWCCCWWWCWWWWWWWWCCCCCCCCCCWWWWWWWWWWWWWWWWWWCWCCCWWCCCWWWCWWWWWWWWCCCCCCCCCCWWWWWWWWWWWWWWWWWWCWCCCWWCCCWWWCWWWWWWWWCCCCCCCCCCWWWWWWWWWWWWWWWWWWCWCCCWWCCCWWWCWWWWWWWWCCCCCCCCCCWWWWWWWWWWWWWWWWWWCWCCCWWCCCWWWCWWWWWWWWCCCCCCCCCCWWWWWWWWWWWWWWWWWWCWCCCWWCCCWWWCWWWWWWWWCCCCCCCCCCWWWWWWWWWWWWWWWWWWCWCCCWWCCCWWWCWWWWWWWWCCCCCCCCCCWWWWWWWWWWWWWWWWWWCWCCCWWCCCWW
WCCCCCWWWWCWWWWWWWWWCCCCCCCCCWWWWWWWCWCCWWWWWWWWWWWCCCCCWWWWCWWWWWWWWWCCCCCCCCCWWWWWWWCWCCWWWWWWWWWWWCCCCCWWWWCWWWWWWWWWCCCCCCCCCWWWWWWWCWCCWWWWWWWWWWWCCCCCWWWWCWWWWWWWWWCCCCCCCCCWWWWWWWCWCCWWWWWWWWWWWCCCCCWWWWCWWWWWWWWWCCCCCCCCCWWWWWWWCWCCWWWWWWWWWWWCCCCCWWWWCWWWWWWWWWCCCCCCCCCWWWWWWWCWCCWWWWWWWWWWWCCCCCWWWWCWWWWWWWWWCCCCCCCCCWWWWWWWCWCCWWWWWWWWWWWCCCCCWWWWCWWWWWWWWWCCCCCCCCCWWWWWWWCWCCWWWWWWWWWWWCCCCCWWWWCWWWWWWWWWCCCCCCCCCWWWWWWWCWCCWWWWWWWWWWWCCCCCWWWWCWWWWWWWWWCCCCCCCCCWWWWWWWCWCCWWWWWWWWWWWCCCCCWWWWCWWWWWWWWWCCCCCCCCCWWWWWWWCWCCWWWWWWWWWWWCCCCCWWWWCWWWWWWWWWCCCCCCCCCWWWWWWWCWCCWWWWWWWWWWWCCCCCWWWWCWWWWWWWWWCCCCCCCCCWWWWWWWCWCCWWWWWWWWWWWCCCCCWWWWCWWWWWWWWWCCCCCCCCCWWWWWWWCWCCWWWWWWWWWWWCCCCCWWWWCWWWWWWWWWCCCCCCCCCWWWWWWWCWCCWWWWWWWWWWWCCCCCWWWWCWWWWWWWWWCCCCCCCCCWWWWWWWCWCCWWWWWWWWWW
WCCCWWWCCCCCCCCCCWWWWWWWWCCCCCWCCCWWCWWCCCCCCCCCCCWCCCWWWCCCCCCCCCCWWWWWWWWCCCCCWCCCWWCWWCCCCCCCCCCCWCCCWWWCCCCCCCCCCWWWWWWWWCCCCCWCCCWWCWWCCCCCCCCCCCWCCCWWWCCCCCCCCCCWWWWWWWWCCCCCWCCCWWCWWCCCCCCCCCCCWCCCWWWCCCCCCCCCCWWWWWWWWCCCCCWCCCWWCWWCCCCCCCCCCCWCCCWWWCCCCCCCCCCWWWWWWWWCCCCCWCCCWWCWWCCCCCCCCCCCWCCCWWWCCCCCCCCCCWWWWWWWWCCCCCWCCCWWCWWCCCCCCCCCCCWCCCWWWCCCCCCCCCCWWWWWWWWCCCCCWCCCWWCWWCCCCCCCCCCCWCCCWWWCCCCCCCCCCWWWWWWWWCCCCCWCCCWWCWWCCCCCCCCCCCWCCCWWWCCCCCCCCCCWWWWWWWWCCCCCWCCCWWCWWCCCCCCCCCCCWCCCWWWCCCCCCCCCCWWWWWWWWCCCCCWCCCWWCWWCCCCCCCCCCCWCCCWWWCCCCCCCCCCWWWWWWWWCCCCCWCCCWWCWWCCCCCCCCCCCWCCCWWWCCCCCCCCCCWWWWWWWWCCCCCWCCCWWCWWCCCCCCCCCCCWCCCWWWCCCCCCCCCCWWWWWWWWCCCCCWCCCWWCWWCCCCCCCCCCCWCCCWWWCCCCCCCCCCWWWWWWWWCCCCCWCCCWWCWWCCCCCCCCCCCWCCCWWWCCCCCCCCCCWWWWWWWWCCCCCWCCCWWCWWCCCCCCCCCCC
WCCCCCCCWWWCCWWWWWCCCWWCCCCCWWWCWCWCCCCWWWWWWCCCWWWCCCCCCCWWWCCWWWWWCCCWWCCCCCWWWCWCWCCCCWWWWWWCCCWWWCCCCCCCWWWCCWWWWWCCCWWCCCCCWWWCWCWCCCCWWWWWWCCCWWWCCCCCCCWWWCCWWWWWCCCWWCCCCCWWWCWCWCCCCWWWWWWCCCWWWCCCCCCCWWWCCWWWWWCCCWWCCCCCWWWCWCWCCCCWWWWWWCCCWWWCCCCCCCWWWCCWWWWWCCCWWCCCCCWWWCWCWCCCCWWWWWWCCCWWWCCCCCCCWWWCCWWWWWCCCWWCCCCCWWWCWCWCCCCWWWWWWCCCWWWCCCCCCCWWWCCWWWWWCCCWWCCCCCWWWCWCWCCCCWWWWWWCCCWWWCCCCCCCWWWCCWWWWWCCCWWCCCCCWWWCWCWCCCCWWWWWWCCCWWWCCCCCCCWWWCCWWWWWCCCWWCCCCCWWWCWCWCCCCWWWWWWCCCWWWCCCCCCCWWWCCWWWWWCCCWWCCCCCWWWCWCWCCCCWWWWWWCCCWWWCCCCCCCWWWCCWWWWWCCCWWCCCCCWWWCWCWCCCCWWWWWWCCCWWWCCCCCCCWWWCCWWWWWCCCWWCCCCCWWWCWCWCCCCWWWWWWCCCWWWCCCCCCCWWWCCWWWWWCCCWWCCCCCWWWCWCWCCCCWWWWWWCCCWWWCCCCCCCWWWCCWWWWWCCCWWCCCCCWWWCWCWCCCCWWWWWWCCCWWWCCCCCCCWWWCCWWWWWCCCWWCCCCCWWWCWCWCCCCWWWWWWCCCWW
WWWWCCWWWWWWWWWWWWCWWWWWWWWWWWWCWWWWWWWWWWWWWWCWWWWWWWCCWWWWWWWWWWWWCWWWWWWWWWWWWCWWWWWWWWWWWWWWCWWWWWWWCCWWWWWWWWWWWWCWWWWWWWWWWWWCWWWWWWWWWWWWWWCWWWWWWWCCWWWWWWWWWWWWCWWWWWWWWWWWWCWWWWWWWWWWWWWWCWWWWWWWCCWWWWWWWWWWWWCWWWWWWWWWWWWCWWWWWWWWWWWWWWCWWWWWWWCCWWWWWWWWWWWWCWWWWWWWWWWWWCWWWWWWWWWWWWWWCWWWWWWWCCWWWWWWWWWWWWCWWWWWWWWWWWWCWWWWWWWWWWWWWWCWWWWWWWCCWWWWWWWWWWWWCWWWWWWWWWWWWCWWWWWWWWWWWWWWCWWWWWWWCCWWWWWWWWWWWWCWWWWWWWWWWWWCWWWWWWWWWWWWWWCWWWWWWWCCWWWWWWWWWWWWCWWWWWWWWWWWWCWWWWWWWWWWWWWWCWWWWWWWCCWWWWWWWWWWWWCWWWWWWWWWWWWCWWWWWWWWWWWWWWCWWWWWWWCCWWWWWWWWWWWWCWWWWWWWWWWWWCWWWWWWWWWWWWWWCWWWWWWWCCWWWWWWWWWWWWCWWWWWWWWWWWWCWWWWWWWWWWWWWWCWWWWWWWCCWWWWWWWWWWWWCWWWWWWWWWWWWCWWWWWWWWWWWWWWCWWWWWWWCCWWWWWWWWWWWWCWWWWWWWWWWWWCWWWWWWWWWWWWWWCWWWWWWWCCWWWWWWWWWWWWCWWWWWWWWWWWWCWWWWWWWWWWWWWWCWWW
CCCCCCCCCCCCCCCCCCCCCCCCCCCCCCCCCCCCCCCCCCCCCCCCCCCCCCCCCCCCCCCCCCCCCCCCCCCCCCCCCCCCCCCCCCCCCCCCCCCCCCCCCCCCCCCCCCCCCCCCCCCCCCCCCCCCCCCCCCCCCCCCCCCCCCCCCCCCCCCCCCCCCCCCCCCCCCCCCCCCCCCCCCCCCCCCCCCCCCCCCCCCCCCCCCCCCCCCCCCCCCCCCCCCCCCCCCCCCCCCCCCCCCCCCCCCCCCCCCCCCCCCCCCCCCCCCCCCCCCCCCCCCCCCCCCCCCCCCCCCCCCCCCCCCCCCCCCCCCCCCCCCCCCCCCCCCCCCCCCCCCCCCCCCCCCCCCCCCCCCCCCCCCCCCCCCCCCCCCCCCCCCCCCCCCCCCCCCCCCCCCCCCCCCCCCCCCCCCCCCCCCCCCCCCCCCCCCCCCCCCCCCCCCCCCCCCCCCCCCCCCCCCCCCCCCCCCCCCCCCCCCCCCCCCCCCCCCCCCCCCCCCCCCCCCCCCCCCCCCCCCCCCCCCCCCCCCCCCCCCCCCCCCCCCCCCCCCCCCCCCCCCCCCCCCCCCCCCCCCCCCCCCCCCCCCCCCCCCCCCCCCCCCCCCCCCCCCCCCCCCCCCCCCCCCCCCCCCCCCCCCCCCCCCCCCCCCCCCCCCCCCCCCCCCCCCCCCCCCCCCCCCCCCCCCCCCCCCCCCCCCCCCCCCCCCCCCCCCCCCCCCCCCCCCCCCCCCCCCCCCCCCCCCCCCCCCCCCCCCCCCCCCCCCCCCCCCCCCCCCCCCCCCCCCCCCCCCCCCCC