CCCCCWWWWWCCCCCWWWWWCCCCCWWWWCCCCCCCCCWWCCCCCWWWWWCCCCCWWWWWCCCCCWWWWWCCCCCWWWWCCCCCCCCCWWCCCCCWWWWW
WWWWCWWWWWWCWWWCCCCWWWWWCCCCCCWWWCWWWCWWWWWWWWWWCCWWWWCWWWWWWCWWWCCCCWWWWWCCCCCCWWWCWWWCWWWWWWWWWWCT
WWWWCCCCCCCWWWWWCWCWWWWWCWCWCWCCCCCCCCCCCCCCCCCCCCWWWWCCCCCCCWWWWWCWCWWWWWCWCWCWCCCCCCCCCCCCCCCCCCCC
WWCCCCCCCCCCCCWWWWWWWCCCCWCWWWWWWWWWWWWWWWWWWWWWCWWWCCCCCCCCCCCCWWWWWWWCCCCWCWWWWWWWWWWWWWWWWWWWWWCW
WCCWWWCWWWWWWCCCCCCCWWWCCWWWCCCCCCCCWWWWWWWWCCCWWCWCCWWWCWWWWWWCCCCCCCWWWCCWWWCCCCCCCCWWWWWWWWCCCWWC
WCCCCWWCWWWWWCCWWCCCCCCWCCCCCCCCCCWCCCCCCCCCCCCCCCWCCCCWWCWWWWWCCWWCCCCCCWCCCCCCCCCCWCCCCCCCCCCCCCCC
WWCWCWCCWWCCWWWWWWWCCCCWWWWWWWCWCWCWWWWWWWWCCCCCCCWWCWCWCCWWCCWWWWWWWCCCCWWWWWWWCWCWCWWWWWWWWCCCCCCC
WCCWCWCCWWCCWWWWWWWCCCCWWWWWWCWCWCCWCCCCCWWCCCCCCCWCCWCWCCWWCCWWWWWWWCCCCWWWWWWCWCWCCWCCCCCWWCCCCCCC
WWWWCWCCWWCCWWWWWWWCCCCWWWWWWCCCCCCCCCWCCCCCCCCCCCWWWWCWCCWWCCWWWWWWWCCCCWWWWWWCCCCCCCCCWCCCCCCCCCCC
WCCCCWWCWWWCWCCCCCWWWCCWWCCCCCWWWWWWWWWWWWWWWCCCWWWCCCCWWCWWWCWCCCCCWWWCCWWCCCCCWWWWWWWWWWWWWWWCCCWW
WCWWWWWCCCCCWWWWWWWWWWCWWCCCCCCCCCCCCCCCCCCCCWWCWWWCWWWWWCCCCCWWWWWWWWWWCWWCCCCCCCCCCCCCCCCCCCCWWCWW
WCCCCCCCCCCCCCCCCCCWWWWWWCCCWWWWWWWWWWWWWWWWCWWCWWWCCCCCCCCCCCCCCCCCCWWWWWWCCCWWWWWWWWWWWWWWWWCWWCWW
CCCCCWWWWWWWWWWWCCCWWWWWWCWWWWWWWWWWWWWWWWWCCCWCCCCCCCCWWWWWWWWWWWCCCWWWWWWCWWWWWWWWWWWWWWWWWCCCWCCC
CCCCCCCCCCCCCCCWWCCCCCCCWWWCCCCCCCCCCCCCCCCCWWWWWWCCCCCCCCCCCCCCCWWCCCCCCCWWWCCCCCCCCCCCCCCCCCWWWWWW
WWCCCWWWWWWCWCWCCCWWWWCCCCWWWWWWCWWWWWCWWCWWCCCCWWWWCCCWWWWWWCWCWCCCWWWWCCCCWWWWWWCWWWWWCWWCWWCCCCWW
WWWWWWWWCCCCWWWWWWWWWWWWWCWWWWCCCCWWWWCCCCWWCWWCWWWWWWWWWWCCCCWWWWWWWWWWWWWCWWWWCCCCWWWWCCCCWWCWWCWW
CCCCCCCCCCCCCCCCCCCCCCCCWCCCCWWWCCCCCCWWWCCCCWWCWWCCCCCCCCCCCCCCCCCCCCCCCCWCCCCWWWCCCCCCWWWCCCCWWCWW
CWWWWWWWWWWWWWWWWWWCCCCCWWWWWWWWCWWWWWWWWCWWWCWCWWCWWWWWWWWWWWWWWWWWWCCCCCWWWWWWWWCWWWWWWWWCWWWCWCWW
WCCCCCCCCCCCWWCWWWWCWWWWWWWWWWWWCCCCCCCCCCWWWCWCWWWCCCCCCCCCCCWWCWWWWCWWWWWWWWWWWWCCCCCCCCCCWWWCWCWW
WCWWWWWWWWCCCCCCCCCCWWWWWWWWWWWWWWWWWWCWCCCWWCCCWWWCWWWWWWWWCCCCCCCCCCWWWWWWWWWWWWWWWWWWCWCCCWWCCCWW
WCCCCCWWWWCWWWWWWWWWCCCCCCCCCWWWWWWWCWCCWWWWWWWWWWWCCCCCWWWWCWWWWWWWWWCCCCCCCCCWWWWWWWCWCCWWWWWWWWWW
WCCCWWWCCCCCCCCCCWWWWWWWWCCCCCWCCCWWCWWCCCCCCCCCCCWCCCWWWCCCCCCCCCCWWWWWWWWCCCCCWCCCWWCWWCCCCCCCCCCC
WCCCCCCCWWWCCWWWWWCCCWWCCCCCWWWCWCWCCCCWWWWWWCCCWWWCCCCCCCWWWCCWWWWWCCCWWCCCCCWWWCWCWCCCCWWWWWWCCCWW
WWWWCCWWWWWWWWWWWWCWWWWWWWWWWWWCWWWWWWWWWWWWWWCWWWWWWWCCWWWWWWWWWWWWCWWWWWWWWWWWWCWWWWWWWWWWWWWWCWWW
CCCCCCCCCCCCCCCCCCCCCCCCCCCCCCCCCCCCCCCCCCCCCCCCCCCCCCCCCCCCCCCCCCCCCCCCCCCCCCCCCCCCCCCCCCCCCCCCCCCC