CCCCCWWWWWCCCCCWWWWWCCCCCWWWWCCCCCCCCCWWCCCCCWWWWWCCCCCWWWWWCCCCCWWWWWCCCCCWWWWCCCCCCCCCWWCCCCCWWWWWCCCCCWWWWWCCCCCWWWWWCCCCCWWWWCCCCCCCCCWWCCCCCWWWWWCCCCCWWWWWCCCCCWWWWWCCCCCWWWWCCCCCCCCCWWCCCCCWWWWW
WWWWCWWWWWWCWWWCCCCWWWWWCCCCCCWWWCWWWCWWWWWWWWWWCCWWWWCWWWWWWCWWWCCCCWWWWWCCCCCCWWWCWWWCWWWWWWWWWWCCWWWWCWWWWWWCWWWCCCCWWWWWCCCCCCWWWCWWWCWWWWWWWWWWCCWWWWCWWWWWWCWWWCCCCWWWWWCCCCCCWWWCWWWCWWWWWWWWWWCT
WWWWCCCCCCCWWWWWCWCWWWWWCWCWCWCCCCCCCCCCCCCCCCCCCCWWWWCCCCCCCWWWWWCWCWWWWWCWCWCWCCCCCCCCCCCCCCCCCCCCWWWWCCCCCCCWWWWWCWCWWWWWCWCWCWCCCCCCCCCCCCCCCCCCCCWWWWCCCCCCCWWWWWCWCWWWWWCWCWCWCCCCCCCCCCCCCCCCCCCC
WWCCCCCCCCCCCCWWWWWWWCCCCWCWWWWWWWWWWWWWWWWWWWWWCWWWCCCCCCCCCCCCWWWWWWWCCCCWCWWWWWWWWWWWWWWWWWWWWWCWWWCCCCCCCCCCCCWWWWWWWCCCCWCWWWWWWWWWWWWWWWWWWWWWCWWWCCCCCCCCCCCCWWWWWWWCCCCWCWWWWWWWWWWWWWWWWWWWWWCW
WCCWWWCWWWWWWCCCCCCCWWWCCWWWCCCCCCCCWWWWWWWWCCCWWCWCCWWWCWWWWWWCCCCCCCWWWCCWWWCCCCCCCCWWWWWWWWCCCWWCWCCWWWCWWWWWWCCCCCCCWWWCCWWWCCCCCCCCWWWWWWWWCCCWWCWCCWWWCWWWWWWCCCCCCCWWWCCWWWCCCCCCCCWWWWWWWWCCCWWC
WCCCCWWCWWWWWCCWWCCCCCCWCCCCCCCCCCWCCCCCCCCCCCCCCCWCCCCWWCWWWWWCCWWCCCCCCWCCCCCCCCCCWCCCCCCCCCCCCCCCWCCCCWWCWWWWWCCWWCCCCCCWCCCCCCCCCCWCCCCCCCCCCCCCCCWCCCCWWCWWWWWCCWWCCCCCCWCCCCCCCCCCWCCCCCCCCCCCCCCC
WWCWCWCCWWCCWWWWWWWCCCCWWWWWWWCWCWCWWWWWWWWCCCCCCCWWCWCWCCWWCCWWWWWWWCCCCWWWWWWWCWCWCWWWWWWWWCCCCCCCWWCWCWCCWWCCWWWWWWWCCCCWWWWWWWCWCWCWWWWWWWWCCCCCCCWWCWCWCCWWCCWWWWWWWCCCCWWWWWWWCWCWCWWWWWWWWCCCCCCC
WCCWCWCCWWCCWWWWWWWCCCCWWWWWWCWCWCCWCCCCCWWCCCCCCCWCCWCWCCWWCCWWWWWWWCCCCWWWWWWCWCWCCWCCCCCWWCCCCCCCWCCWCWCCWWCCWWWWWWWCCCCWWWWWWCWCWCCWCCCCCWWCCCCCCCWCCWCWCCWWCCWWWWWWWCCCCWWWWWWCWCWCCWCCCCCWWCCCCCCC
WWWWCWCCWWCCWWWWWWWCCCCWWWWWWCCCCCCCCCWCCCCCCCCCCCWWWWCWCCWWCCWWWWWWWCCCCWWWWWWCCCCCCCCCWCCCCCCCCCCCWWWWCWCCWWCCWWWWWWWCCCCWWWWWWCCCCCCCCCWCCCCCCCCCCCWWWWCWCCWWCCWWWWWWWCCCCWWWWWWCCCCCCCCCWCCCCCCCCCCC
WCCCCWWCWWWCWCCCCCWWWCCWWCCCCCWWWWWWWWWWWWWWWCCCWWWCCCCWWCWWWCWCCCCCWWWCCWWCCCCCWWWWWWWWWWWWWWWCCCWWWCCCCWWCWWWCWCCCCCWWWCCWWCCCCCWWWWWWWWWWWWWWWCCCWWWCCCCWWCWWWCWCCCCCWWWCCWWCCCCCWWWWWWWWWWWWWWWCCCWW
WCWWWWWCCCCCWWWWWWWWWWCWWCCCCCCCCCCCCCCCCCCCCWWCWWWCWWWWWCCCCCWWWWWWWWWWCWWCCCCCCCCCCCCCCCCCCCCWWCWWWCWWWWWCCCCCWWWWWWWWWWCWWCCCCCCCCCCCCCCCCCCCCWWCWWWCWWWWWCCCCCWWWWWWWWWWCWWCCCCCCCCCCCCCCCCCCCCWWCWW
WCCCCCCCCCCCCCCCCCCWWWWWWCCCWWWWWWWWWWWWWWWWCWWCWWWCCCCCCCCCCCCCCCCCCWWWWWWCCCWWWWWWWWWWWWWWWWCWWCWWWCCCCCCCCCCCCCCCCCCWWWWWWCCCWWWWWWWWWWWWWWWWCWWCWWWCCCCCCCCCCCCCCCCCCWWWWWWCCCWWWWWWWWWWWWWWWWCWWCWW
CCCCCWWWWWWWWWWWCCCWWWWWWCWWWWWWWWWWWWWWWWWCCCWCCCCCCCCWWWWWWWWWWWCCCWWWWWWCWWWWWWWWWWWWWWWWWCCCWCCCCCCCCWWWWWWWWWWWCCCWWWWWWCWWWWWWWWWWWWWWWWWCCCWCCCCCCCCWWWWWWWWWWWCCCWWWWWWCWWWWWWWWWWWWWWWWWCCCWCCC
CCCCCCCCCCCCCCCWWCCCCCCCWWWCCCCCCCCCCCCCCCCCWWWWWWCCCCCCCCCCCCCCCWWCCCCCCCWWWCCCCCCCCCCCCCCCCCWWWWWWCCCCCCCCCCCCCCCWWCCCCCCCWWWCCCCCCCCCCCCCCCCCWWWWWWCCCCCCCCCCCCCCCWWCCCCCCCWWWCCCCCCCCCCCCCCCCCWWWWWW
WWCCCWWWWWWCWCWCCCWWWWCCCCWWWWWWCWWWWWCWWCWWCCCCWWWWCCCWWWWWWCWCWCCCWWWWCCCCWWWWWWCWWWWWCWWCWWCCCCWWWWCCCWWWWWWCWCWCCCWWWWCCCCWWWWWWCWWWWWCWWCWWCCCCWWWWCCCWWWWWWCWCWCCCWWWWCCCCWWWWWWCWWWWWCWWCWWCCCCWW
WWWWWWWWCCCCWWWWWWWWWWWWWCWWWWCCCCWWWWCCCCWWCWWCWWWWWWWWWWCCCCWWWWWWWWWWWWWCWWWWCCCCWWWWCCCCWWCWWCWWWWWWWWWWCCCCWWWWWWWWWWWWWCWWWWCCCCWWWWCCCCWWCWWCWWWWWWWWWWCCCCWWWWWWWWWWWWWCWWWWCCCCWWWWCCCCWWCWWCWW
CCCCCCCCCCCCCCCCCCCCCCCCWCCCCWWWCCCCCCWWWCCCCWWCWWCCCCCCCCCCCCCCCCCCCCCCCCWCCCCWWWCCCCCCWWWCCCCWWCWWCCCCCCCCCCCCCCCCCCCCCCCCWCCCCWWWCCCCCCWWWCCCCWWCWWCCCCCCCCCCCCCCCCCCCCCCCCWCCCCWWWCCCCCCWWWCCCCWWCWW
CWWWWWWWWWWWWWWWWWWCCCCCWWWWWWWWCWWWWWWWWCWWWCWCWWCWWWWWWWWWWWWWWWWWWCCCCCWWWWWWWWCWWWWWWWWCWWWCWCWWCWWWWWWWWWWWWWWWWWWCCCCCWWWWWWWWCWWWWWWWWCWWWCWCWWCWWWWWWWWWWWWWWWWWWCCCCCWWWWWWWWCWWWWWWWWCWWWCWCWW
WCCCCCCCCCCCWWCWWWWCWWWWWWWWWWWWCCCCCCCCCCWWWCWCWWWCCCCCCCCCCCWWCWWWWCWWWWWWWWWWWWCCCCCCCCCCWWWCWCWWWCCCCCCCCCCCWWCWWWWCWWWWWWWWWWWWCCCCCCCCCCWWWCWCWWWCCCCCCCCCCCWWCWWWWCWWWWWWWWWWWWCCCCCCCCCCWWWCWCWW
WCWWWWWWWWCCCCCCCCCCWWWWWWWWWWWWWWWWWWCWCCCWWCCCWWWCWWWWWWWWCCCCCCCCCCWWWWWWWWWWWWWWWWWWCWCCCWWCCCWWWCWWWWWWWWCCCCCCCCCCWWWWWWWWWWWWWWWWWWCWCCCWWCCCWWWCWWWWWWWWCCCCCCCCCCWWWWWWWWWWWWWWWWWWCWCCCWWCCCWW
WCCCCCWWWWCWWWWWWWWWCCCCCCCCCWWWWWWWCWCCWWWWWWWWWWWCCCCCWWWWCWWWWWWWWWCCCCCCCCCWWWWWWWCWCCWWWWWWWWWWWCCCCCWWWWCWWWWWWWWWCCCCCCCCCWWWWWWWCWCCWWWWWWWWWWWCCCCCWWWWCWWWWWWWWWCCCCCCCCCWWWWWWWCWCCWWWWWWWWWW
WCCCWWWCCCCCCCCCCWWWWWWWWCCCCCWCCCWWCWWCCCCCCCCCCCWCCCWWWCCCCCCCCCCWWWWWWWWCCCCCWCCCWWCWWCCCCCCCCCCCWCCCWWWCCCCCCCCCCWWWWWWWWCCCCCWCCCWWCWWCCCCCCCCCCCWCCCWWWCCCCCCCCCCWWWWWWWWCCCCCWCCCWWCWWCCCCCCCCCCC
WCCCCCCCWWWCCWWWWWCCCWWCCCCCWWWCWCWCCCCWWWWWWCCCWWWCCCCCCCWWWCCWWWWWCCCWWCCCCCWWWCWCWCCCCWWWWWWCCCWWWCCCCCCCWWWCCWWWWWCCCWWCCCCCWWWCWCWCCCCWWWWWWCCCWWWCCCCCCCWWWCCWWWWWCCCWWCCCCCWWWCWCWCCCCWWWWWWCCCWW
WWWWCCWWWWWWWWWWWWCWWWWWWWWWWWWCWWWWWWWWWWWWWWCWWWWWWWCCWWWWWWWWWWWWCWWWWWWWWWWWWCWWWWWWWWWWWWWWCWWWWWWWCCWWWWWWWWWWWWCWWWWWWWWWWWWCWWWWWWWWWWWWWWCWWWWWWWCCWWWWWWWWWWWWCWWWWWWWWWWWWCWWWWWWWWWWWWWWCWWW
CCCCCCCCCCCCCCCCCCCCCCCCCCCCCCCCCCCCCCCCCCCCCCCCCCCCCCCCCCCCCCCCCCCCCCCCCCCCCCCCCCCCCCCCCCCCCCCCCCCCCCCCCCCCCCCCCCCCCCCCCCCCCCCCCCCCCCCCCCCCCCCCCCCCCCCCCCCCCCCCCCCCCCCCCCCCCCCCCCCCCCCCCCCCCCCCCCCCCCCC
