CCCCWWWWWW
CCCCWWWWWW
CCCCCCWWWW
CCCCCCWWWW
WWWWCCCCCC
WWWWWWCCCC
WWWWWWCCCC
WWWWWWTCCC