CCCCCCCCCCCCCCC
CWCCCCCWCCCCCWC
CCCWWCCCCCWWCCC
CWCCCCCWCCCCCWC
CCCWWCCCCCWWCCC
CWCCCCCWCCCCCWT
CCCWWCCCCCWWCC
CWCCCCCWCCCCCWC
CCCCCCCCCCCCCCC