TCCCCCCCCC
WWWWWWWWWC
CCCCCCCCCC
CWWWWWWWWW
CCCCCCCCCC
WWWWWWWWWC
CCCCCCCCCC
CWWWWWWWWW
CCCCCCCCCC
WWWWWWWWWW