CCCCCCCCCC
CCCCCWWWWC
CWWCTWWWWC
CWWWCCWWWC
CWWWWCCWWC
CWWWWWCCCC
CWWWWWTCCC
CCCCCCCCCC