CCCCCCCCCC
WWWWWWWWWC
CCCCCCCCCC
WWWWWWWWWC
CCCCCCCCCC
CWWWWWWWWW
CCCCCCCCCC
WWWWWWWWWC
CCCCTCCCCC
CCCCCCCCCC