CCCCCCCCCW
CCWCWCCCCC
CCWTWCCCCC
CCWWWCCCCC
CCCCCCCCCC
CCCCCCCCCC