CCCCCWCCCC
CCCCCWCCCC
WWWWCCCCWC
CCTWCWWCCC
CCCWCCWCWC
CWWWCCWWCC
CWCWWWWCCC
CWCCWCCCCC
CWCCCCCWCC
CCCCCCCWCC