CWWWWTCCCC
CWCCCCCCCC
CWCCCCCCCC
CCCCCCCCCC
CCCCWWWWWW
CCCCWCCCCC