CWWWWCCCCC
CWCCCCCCCC
CWCCCCCCCC
CCCCCCCCCC
CCCCWWWWWC
CCCCWTCCCC