CCCCCCCCWW
CWWWWWWCCW
CCCCWCCCCW
WWWWCCWWCC
CCTCWCCCCC
CCCCCWWCCC
WWWWWWCCCC
CCCCWCCWWW
CTCCCCCCCW
CCCCCCWCCC