CCCCCCCCCW
CWWWWCCWCT
CCCCCCCWCC
CCCCCCCWCC
CCCCCCCWCC
CCCCCCCCCC
CCCCCCCCCC
CCCCCCCCCC
CCCCCCWWWC
CCCCCCCCCC