CCCWWWCCCC
CWCCCWCCCC
CWCCCWCWWW
CWWWWWCCCC
CCCCCCCCCC
CCWWWWWWCC
CCWCCCCCCC
CCWCCCCWCC
CCCWWCWWCW
CCWTCCCWCC