CCCCCCWCCC
CWWWWWWCWC
CCCCCCCCWC
CWWWWWWWWC
CCCCCCCCWC
CWWWWWWWWC
CCCWCCCCWC
CWCCCWCCWC
CWWWWWWWWC
CCCCCCCCWT