CCCCCCCCCC
WWWWWWWWWC
CCCCCCCCCC
WCWWWWWWWW
CCCCCCCCCC
WCWWWWWWWC
CCCCCCCCCC
WWWWWWWWCW
CCCCCCCCCC
TCCCCCCCCC