CWWWWWWWWT
CCCWWWWWWC
CCCWCCCCCC
WWCWWWWWWc
WWCCCCCWWc
CCCWWWWWWC
CCCCCCCCCC
WWWWWWCWWW
CCCCCCCCCC
WWWWWWWWWc