WWWWWWCCCC
CCWCCWCCCC
CCCCCCWWCC
CCCCCCCCWW
WCCCCCCCCW
TCCCWCCCCW
WWWWWCCWWC
CCCCCCCCCC
CCCCCCWCCC
CCCCCCCCWC