CWWWCCCWWW
CCCCCWCCCC
WWWWWWWWCW
CCCCCCCCCC
CCCCCCCCCC
CCCCCCCCCC
CCCCWWWWWC
CCCCCCTWCC
CCCCCCCWCC
CCCCCCCCCC