CCCCCCCCCC
CWCWWWWWWC
CWCCCCCCWC
CWCWWWWCWC
CWCWCCCCWC
CWCWCCWCWC
CWCWWCWWWW
CWCCWCCCCC
CWWWWWWWWC
CCCCCCCCWT