CWCCCCCCCCWCCCCCCCW
CWCCCCWCCCWCWWWWWCC
CWCWCCWCCCWCWCCCCCC
CWCCWCWWWCWCWCWWWWW
CCCWCCCCWCWCWCCCCC
CWCCCCCCWCWCW
CCCCCCCCWCWCWWWW
CCCCCCCCWCWCCCCW
CCCCCCCCWCWCWWWWWWC
CCCCCCCCWCCCWWWWWCC
CCCCCWWWWCCWTCCCCCW