CWCCCWCCCW
CCCWCCCWCC
WWWWWWWWWC
CCCWCCCWCC
CWCCCWCCCW
CWWWWWWWWW
CCWCCCWCCC
WCCCWCCCWC
WWWWWCWWWC
CCCCCCCCWT