CCCCCCCWCC
CCCCCCCWCC
CCCCCCCWCC
CCCCCCCWCC
CCCCCCCWCC
CCCCCCCWCC
WWWWWCWWCC
CCCCCCTCCC
CCCCCCCCCC
CCCCCCCCCC