CCCCCCCCCC
WWWWWWWWWC
CCCCCCCCCC
WCWWWCCWCW
CCCCCWCCCC
CCWWCWWWWC
CWCCCCCCCC
CWCWCCWWWW
CWCCWWWCCC
CWCCCCTCCC